###########
#        R#
#  #      #
#S #      #
#  #      #
#  #      #
#         #
###########