###############################################################
###############################################################
###############################################################
###############################################################
###############################################################
###############################################################
###############################################################
#########   ###########   ###########   ###########  R#########
#########   ###########   ###########   ###########   #########
#########                 ###########                 #########
#########                 ###########                 #########
#########                 ###########                 #########
#########   ####   ####   ###########   ####   ####   #########
#########   ####   ####   ###########   ####   ####   #########
################   #########################   ################
################   #########################   ################
################                               ################
################                               ################
################                               ################
################   ###########   ###########   ################
################   ###########   ###########   ################
#########   ####   ####   ####   ####   ####   ####   #########
#########   ####   ####   ####   ####   ####   ####   #########
#########                 ####   ####                 #########
#########                 ####   ####                 #########
#########                 ####   ####                 #########
#########   ###########   ####   ####   ###########   #########
#########   ###########   ####   ####   ###########   #########
##############################   ##############################
##############################   ##############################
##                               ##############################
##S                              ##############################
##                               ##############################
##############################   ##############################
##############################   ##############################
#########   ###########   ####   ####   ###########   #########
#########   ###########   ####   ####   ###########   #########
#########                 ####   ####                 #########
#########                 ####   ####                 #########
#########                 ####   ####                 #########
#########   ####   ####   ####   ####   ####   ####   #########
#########   ####   ####   ####   ####   ####   ####   #########
################   ###########   ###########   ################
################   ###########   ###########   ################
################                               ################
################                               ################
################                               ################
################   #########################   ################
################   #########################   ################
#########   ####   ####   ###########   ####   ####   #########
#########   ####   ####   ###########   ####   ####   #########
#########                 ###########                 #########
#########                 ###########                 #########
#########                 ###########                 #########
#########   ###########   ###########   ###########   #########
#########   ###########   ###########   ###########   #########
###############################################################
###############################################################
###############################################################
###############################################################
###############################################################
###############################################################
###############################################################