#############################################
#############################################
#############################################
#############################################
#############################################
#####     #####     #####     #####    R#####
####### ######### ######### ######### #######
#######           #########           #######
####### #### #### ######### #### #### #######
#####     ## ##     #####     ## ##     #####
############ ################### ############
############ ################### ############
############                     ############
############ ######### ######### ############
############ ######### ######### ############
#####     ## ##     ## ##     ## ##     #####
####### #### #### #### #### #### #### #######
#######           #### ####           #######
####### ######### #### #### ######### #######
#####     #####     ## ##     #####     #####
###################### ######################
###################### ######################
##S                    ######################
###################### ######################
###################### ######################
#####     #####     ## ##     #####     #####
####### ######### #### #### ######### #######
#######           #### ####           #######
####### #### #### #### #### #### #### #######
#####     ## ##     ## ##     ## ##     #####
############ ######### ######### ############
############ ######### ######### ############
############                     ############
############ ################### ############
############ ################### ############
#####     ## ##     #####     ## ##     #####
####### #### #### ######### #### #### #######
#######           #########           #######
####### ######### ######### ######### #######
#####     #####     #####     #####     #####
#############################################
#############################################
#############################################
#############################################
#############################################