###########
#       #R#
###      # #
#S ###    # #
###        #
#  ###   #   #
#         #
###########