#########################
#########################
#########################
#########################
#########################
#####     #####    R#####
####### ######### #######
#######           #######
####### #### #### #######
#####     ## ##     #####
############ ############
############ ############
##S          ############
############ ############
############ ############
#####     ## ##     #####
####### #### #### #######
#######           #######
####### ######### #######
#####     #####     #####
#########################
#########################
#########################
#########################
#########################