#####################################
#     #####     #####     #####    R#
### ######### ######### ######### ###
###           #########           ###
### #### #### ######### #### #### ###
#     ## ##     #####     ## ##     #
######## ################### ########
######## ################### ########
########                     ########
######## ######### ######### ########
######## ######### ######### ########
#     ## ##     ## ##     ## ##     #
### #### #### #### #### #### #### ###
###           #### ####           ###
### ######### #### #### ######### ###
#     #####     ## ##     #####     #
################## ##################
################## ##################
#S                 ##################
################## ##################
################## ##################
#     #####     ## ##     #####     #
### ######### #### #### ######### ###
###           #### ####           ###
### #### #### #### #### #### #### ###
#     ## ##     ## ##     ## ##     #
######## ######### ######### ########
######## ######### ######### ########
########                     ########
######## ################### ########
######## ################### ########
#     ## ##     #####     ## ##     #
### #### #### ######### #### #### ###
###           #########           ###
### ######### ######### ######### ###
#     #####     #####     #####     #
#####################################